c----..----c
|..........|
|..........|
|..........|
|..........|
............
............
|..........|
|..........|
|..........|
|..........|
c----..----c