c----..----c
|..........|
|..........|
|..........|
|..........|
...........|
...........|
|.......t..|
|..........|
|..........|
|..........|
c----..----c