c----..----c
|..........|
|..........|
|..........|
|..........|
|...........
|...........
|..........|
|..........|
|.........e|
|..........|
c----..----c