c----..----c
|..........|
|.....t....|
|..........|
|..........|
|..........|
|....t.....|
|..........|
|..........|
|..........|
|t.......t.|
c----..----c