c----..----c
|..........|
|......e...|
|..........|
|..........|
............
............
|..........|
|..........|
|...e......|
|........e.|
c----..----c