c----..----c
|t........t|
|..........|
|..........|
|..........|
.....ee.....
.....ee.....
|..........|
|..........|
|..........|
|t........t|
c----..----c