c----tt----c
|e........e|
|..........|
|..........|
|....ee....|
t...ette...t
t...ette...t
|....ee....|
|..........|
|..........|
|e........e|
c----tt----c