c----..----c
|..........|
|.e......e.|
|..........|
|..........|
............
....t.......
|..........|
|........t.|
|....e.....|
|..........|
c----..----c